+-----+----+---+------------------+
|     |    |   |                  |
+ ----+ +--+-- +---- +-----+----- +
|       |  |         |     |      |
+ ---+ -+ -+ + ---+--+- +--+-+--- +
|    |     | |          |    |    |
+----+---- + + ---+-- +-+--- +----+
|    |       |    |   |           |
+ + -+ ------+--- + --+ -----+ ---+
| |          |    |   |      |    |
+ +--+---+ --+ +--+-- +----- +--- +
|    |   |   | |             |    |
+----+ --+---+ + -+-- +----+-+----+
|            |    |        |      |
+-- + --+ ---+ +- + -+ ----+----- +
|   |   |      |     |            |
+ --+---+ +--- +--+--+ ----+-- ---+
|   |     |       |        |      |
+---+-----+-------+--------+------+
