+-----+--------+------------------+
|     |        |                  |
+ ----+ +--+-- +---- +-----+----- +
|       |  |         |     |      |
+ ---+ -+ -+ + ---+--+- +--+-+--- +
|    |     | |    |     |    |    |
+----+---- + + ---+-- +-+--- +--- +
|    |       |    |   |           |
+ + -+ ------+--- + --+ -----+ ---+
| |          |    |   |      |    |
+ +--+---+ --+ +--+-- +----- +--- +
|    |   |     |             |    |
+----+ --+--+- + -+-- +----+-+----+
|           |     |        |      |
+-- + --+ --+- +- + -+ ----+----- +
|   |   |      |     |            |
+ --+---+ +--- +--+--+ ----+-- ---+
|   |     |       |        |      |
+---+-----+-------+--------+------+
